1 1
11111121111111111111
10100010000000000000
10201011101110111120
10001000100020001020
11111110111011101010
10121000001020002000
10111211101010111011
10001210001010100000
10101110211110211112
10100000000000122023
